SO ./assets/brick/brick3.xpm  
WE ./assets/other/other4.xpm  
EA ./assets/wood/wood1.xpm  
NO ./assets/paper/paper2.xpm  

CE ./assets/carpet/carpet4.xpm  
FL ./assets/wood/wood3.xpm  

1111111  
1000001  
1000001  
1000001  
100S001  
1111111  
