SO ./assets/other/other2.xpm  
WE ./assets/brick/brick1.xpm  
EA ./assets/paper/paper3.xpm  
NO ./assets/wood/wood4.xpm  

CE ./assets/carpet/carpet1.xpm  
FL ./assets/wood/wood2.xpm  

11111  
1N001   
10001  
11011
111 1
