SO ./assets/brick/brick4.xpm
WE ./assets/brick/brick4.xpm
EA ./assets/brick/brick4.xpm
NO ./assets/brick/brick4.xpm

CE ./assets/paper/paper3.xpm
FL ./assets/other/other4.xpm

11111111111111111
10000000000000001
10004000000000001
10000000300000001
10000000000020001
100000000000000N1
11111111111111111
