SO ./assets/other/other1.xpm
WE ./assets/other/other1.xpm
EA ./assets/other/other1.xpm
NO ./assets/other/other1.xpm

CE ./assets/paper/paper3.xpm
FL ./assets/brick/brick4.xpm

1111111
1000001
1000001
1000001
1000001
1000001
1000001
1000001
1000001
1000001
1000001
1000001
1000001
1000001
1000001
1000001
1000001
1000001
1000001
1000001
1000001
1000001
1001001
1002101
1001001
1000001
1000001
1000001
1000001
1000001
1004001
1003001
1000001
1000001
1000001
1000001
1000001
1000001
1000001
1003001
1004001
1000001
1000001
1000001
1400041
1030301
100N001
1111111
