
SO ./assets/64/cordial/south.xpm
WE ./assets/64/cordial/west.xpm
EA ./assets/64/cordial/east.xpm
NO ./assets/64/cordial/north.xpm


C 1 , 155 , 255
F 0 , 255 , 100

111111111111111111
111111111111111111
111111111111111111
111111111111111111
