
SO ./assets/south.xpm
WE ./assets/west.xpm
EA ./assets/east.xpm
NO ./assets/north.xpm


C 0 , 155 , 255
F 0 , 255 , 100

111111111111111111
100000000000000001
100000000000000001
100111110010101001
100100010000000001
100000010010001001
100100010000000001
100111110010101001
100000000000000001
100000000000000001
100001111111100001
10001        10001
10001        10N01
10001        10001
100001111111100001
100000000000000001
100000000000000001
111111111000000001
110100001000000001
110000101000000001
110100001000000001
110111111000000001
110000000000000001
111111111000000101
111111111111111111
