SO ./tiles/cake.xpm

WE ./tiles/bg.xpm

EA ./tiles/exit.xpm

F 36 , 85 , 5

C 51 , 53 , 51

NO ./tiles/ghost_l.xpm


11111111111
1000000000111111
1000000000000111
1111100000000001
1111000000000011
1100000000000001
1000000000000001111111
1000000000000000000001
10000000000000000000W1
1111111111111111111111
