NO ./assets/other/other4.xpm
SO ./assets/paper/paper1.xpm
WE ./assets/paper/paper2.xpm
EA ./assets/paper/paper3.xpm

FL ./assets/wood/wood3.xpm
CE ./assets/wood/wood3.xpm

11111111111111
10000000000201
10000000000001
10000000000N01
11111111111111